TILEMAP
15 15							-- Size of tile map in tiles
24 24							-- Tile size & block size
images/blocksBaba.png					-- Tilesheet
2 2								-- Number of tiles in tilesheet
111111111111111
122222222222221
122222222222221
122333333333321
122222222222321
122222223222321
122222223222321
122222223333321
122222222222221
122222222222221
122222222222221
122222222222221
122222222222221
122222222221221
111111111111111