TILEMAP
25 25							-- Size of tile map in tiles
24 24							-- Tile size & block size
images/blocksBaba.png					-- Tilesheet
2 2								-- Number of tiles in tilesheet
4444444444444444444444444
4000000111111111111111004
4000000122222222222221004
4000000122222222222221004
4000000122333333333321004
4000000122222222222321004
4000000122222223222321004
4000000122222223222321004
4000000122222223333321004
4000000122222222222221004
4000000122222222222221004
4000000122222222222221004
4000000122222222222221004
4000000122222222222221004
4000000122222222222221004
4000000111111111111111004
4444444444444444444444444

