TILEMAP
26 20							-- Size of tile map in tiles
24 24							-- Tile size & block size
images/blocksBaba.png					-- Tilesheet
3 2								-- Number of tiles in tilesheet
00000000000000000000000000
00000030000000000000000000
00000000000111111111000300
00000000000100000001200000
00300000000100000001000000
00000000000100000001000000
00000300111100000001000030
00200000133300000001002000
00000000130300000001000000
00000020133300000001000002
00000000111111111111030000
00030000000010000001000000
00000000000010000001000000
00000030000010000001000020
00300000000010000001000000
00002000000010000001020300
00000002000010000001000000
00000300002010000111000000
00300300000011111100003000
00000000000000000000000000




Baba 17 15
Object WallM 14 14
Relation Is 14 15
Property Stop 14 16
Object BabaM 9 14
Relation Is 9 15
Property You 9 16
Object FlagM 10 8
END